111111111111111111111111111111111111111111111111111
150000000000000000000000000000000000000000000000001
100000000000000000000000000000000000000000000000001
100000000000000000000000000000000000000000000000001
100000000000000000000000000000000000000000000000001
100000000000000000000000000000000000000000000000001
100000000000000000000000000000000000000000000000001
100000100000000000011111111111110000000000000100001
100000100000000000000000000000000000000000000100001
100000100000000000000000000000000000000000000100001
100400100000000000000000050000000000000000000100001
100000100000000000000000000000000000000000004100001
100000100000000000000000000000000000000000000100001
100000100000000000000000000000000000000000000100001
100000100000000000000000000000000000000000000100001
100000100000000000000000000000000000000000000100001
100000000000000000002222222222200000000000000000001
100000000000000000000000000000000000000000000000001
100000000000000000000000000000000000000000000000001
100000000000000000000000000000000000000000000000001
100000022220000000000004000000000000000000000000001
100000020000000000020000000000020000000003002000001
100000020030000000020000000000020000000000002000001
100000000000000000000000000400000000000002222000001
100000000000000000000000000000000000000000000000001
100000000000000000000000000000000000000000000000001
100000000000000000000000000000000000000000000000001
100000000000000000000222222222000000000000000000001
100000100000000000000000000000000000000000001000001
100000100000000000000000000000000000000000001000001
100000100000000000000000000000000000000000001000001
100000100000000000000000000000000000000000001000001
100000100000000000000000000000000000000000001000001
100000100000000000000000050000000000000000001004001
100000100000000000000000000000000000000000001000001
100000100000000000000000000000000000000000001000001
100000100000000000011111111111110000000000001000001
100000000000000000000000000000000000000000000000001
100000000000000000000000000000000000000000000000001
100000000000000000000000000000000000000000000000001
100000000000000000000000000000000000000000000000051
111111111111111111111111111111111111111111111111111